6 6 0 0 6 6 6 0 0 0 6 0 0 8 8 8 8 8 8 8 8 8 8 8 0 8 8 8 8 8 0 0 0 0 0 7 7 7 7 7 7 7 7 7 7 7 7 7 7 7
0 6 0 0 6 0 0 6 0 0 6 0 0 0 0 0 0 8 8 8 8 8 8 8 0 0 0 0 0 8 8 0 8 0 0 7 7 7 7 7 7 7 7 7 7 7 7 7 7 7 
0 0 0 6 6 0 0 6 0 6 6 0 0 0 0 0 0 8 0 0 0 8 8 0 0 0 0 8 6 6 6 8 8 8 6 7 7 7 7 7 7 7 7 7 7 7 7 7 7 7
0 0 0 6 0 0 6 6 0 0 6 0 0 8 8 8 0 0 0 0 0 0 0 0 8 8 0 8 6 8 6 8 8 8 6 7 7 7 7 7 7 7 7 7 7 7 7 7 7 7
6 6 6 0 0 0 0 6 6 6 6 0 0 0 0 0 0 0 0 0 8 8 0 6 6 8 0 0 6 0 0 0 0 0 6 7 7 7 7 7 7 7 7 7 7 7 7 7 7 7
0 0 6 6 6 6 6 1 1 1 1 1 1 1 1 8 8 0 8 0 0 0 0 0 0 0 0 0 0 0 0 0 6 6 0 7 7 7 7 7 7 7 7 7 7 7 7 7 7 7
0 0 6 6 0 0 6 1 5 5 5 5 5 5 1 0 6 0 3 0 0 6 6 6 6 0 6 6 6 6 6 0 0 0 6 6 6 6 0 6 0 0 7 7 7 7 7 7 7 7 
0 6 0 0 0 0 6 1 5 5 5 5 5 5 1 6 6 0 3 0 6 6 6 6 6 0 6 0 0 0 0 0 6 0 6 6 0 0 0 6 6 6 0 6 0 6 6 6 0 0 
0 6 0 0 0 0 0 1 5 5 5 5 5 5 1 8 6 0 3 6 6 0 6 6 6 0 6 0 6 0 6 6 6 6 6 6 0 6 6 6 6 0 0 6 6 0 6 0 0 0 
0 0 6 0 6 0 0 1 5 5 5 5 5 5 1 6 6 0 3 0 6 0 0 0 6 0 6 0 6 0 6 0 0 0 0 0 0 6 6 6 6 0 6 0 6 0 0 6 0 0 
0 0 6 6 6 6 0 1 5 5 5 5 5 5 1 6 8 0 3 0 6 0 0 6 6 6 6 6 6 0 6 6 6 6 6 6 6 6 6 0 6 0 6 0 6 0 0 0 6 6  
0 0 0 6 6 6 0 1 5 1 1 1 1 1 1 0 0 6 3 0 6 6 6 6 6 0 0 0 6 0 6 6 0 0 0 0 0 0 6 6 6 6 0 0 6 0 6 0 6 6 
0 0 0 0 0 6 0 0 4 6 6 6 6 6 6 6 0 0 3 0 0 6 0 0 0 0 6 6 6 6 6 6 6 0 0 0 6 0 0 0 0 6 0 0 6 0 0 6 6 6 
0 6 0 6 0 0 0 0 4 6 8 8 8 8 8 0 6 6 3 0 0 6 0 6 6 0 0 0 0 6 0 0 6 6 6 0 6 6 6 0 0 6 0 0 6 6 6 6 0 0  
0 6 0 6 0 6 0 0 4 6 8 8 0 8 8 8 6 6 3 0 0 6 0 6 6 6 6 6 6 6 6 0 0 6 6 0 6 6 0 6 0 6 0 0 0 0 6 0 0 0 
0 6 6 6 0 6 0 0 4 6 8 8 0 0 0 8 6 8 3 0 0 6 0 6 0 6 6 0 0 0 6 6 0 6 6 0 6 6 0 6 6 6 0 0 6 6 0 6 6 6  
0 0 6 0 0 0 0 0 4 6 0 0 8 8 8 8 6 8 3 8 0 6 0 6 0 0 0 0 0 0 6 6 6 6 6 0 6 0 0 0 6 0 6 0 0 0 0 6 0 0 
0 0 6 0 0 6 6 0 4 6 6 6 6 6 6 6 6 0 3 0 0 6 6 6 0 6 6 6 0 6 0 6 0 0 0 0 6 6 0 0 0 0 0 0 0 0 6 6 0 0 
0 0 6 0 0 0 0 0 4 4 4 4 4 4 4 4 4 4 4 0 0 0 0 0 6 6 6 6 0 6 0 6 6 6 6 0 0 6 6 6 6 0 6 0 0 0 0 0 6 6 
6 6 6 6 0 0 0 0 0 0 0 6 0 0 0 0 0 0 4 0 0 0 0 0 0 0 6 0 0 0 0 0 0 0 0 0 0 0 6 0 0 0 6 6 6 6 0 0 6 0 
0 0 0 6 6 6 6 0 6 6 6 6 6 6 6 6 6 0 4 4 4 4 4 4 4 4 4 4 4 4 4 0 0 0 6 0 0 0 0 0 0 0 0 0 0 6 0 0 6 0 
0 0 0 6 0 0 0 0 6 0 6 6 6 0 6 6 6 0 0 0 0 0 0 6 0 0 0 0 0 0 4 3 3 3 3 3 3 3 3 3 3 3 0 0 0 6 0 6 6 0 
0 0 0 6 0 0 0 0 6 0 6 6 6 0 0 0 6 6 6 6 6 6 6 6 6 6 6 6 6 0 4 0 6 6 6 6 6 6 6 6 6 6 0 6 0 6 0 0 6 0 
0 0 6 0 0 0 0 0 6 0 6 6 0 0 6 6 0 6 6 6 0 6 6 6 6 6 6 6 6 0 4 0 6 0 6 0 0 0 0 6 0 6 0 6 0 6 6 6 6 6 
6 6 6 0 0 0 0 0 6 0 0 6 6 6 6 6 0 6 6 6 0 0 0 0 6 0 0 6 6 0 4 0 6 0 6 6 6 6 6 6 6 0 0 6 0 0 0 0 0 0 
0 0 0 0 0 0 0 0 0 0 6 0 6 0 0 0 0 6 6 6 6 6 6 0 6 6 0 6 6 0 4 0 6 0 6 0 0 0 0 0 0 6 0 6 0 6 6 0 0 0 
0 0 0 0 0 0 6 0 6 0 6 6 6 0 6 6 6 6 0 0 0 6 6 0 6 6 6 6 6 0 4 0 6 0 6 0 6 6 6 6 0 6 0 0 0 0 6 6 6 0 
0 6 6 0 0 6 6 0 6 0 0 6 6 0 6 6 6 6 6 6 6 6 6 0 6 6 0 0 6 0 4 6 6 0 6 0 6 0 0 6 0 6 0 6 6 0 0 0 6 6  
6 6 6 6 0 6 0 0 6 6 0 6 6 0 6 6 6 0 0 6 6 6 6 6 6 0 0 6 6 0 4 0 6 6 6 0 6 0 0 6 0 6 0 0 0 0 0 0 0 6 
0 0 6 6 6 6 0 0 0 6 6 6 6 0 6 0 6 6 6 6 6 6 6 6 6 6 6 6 6 6 4 0 6 6 6 0 6 6 6 6 6 6 0 6 0 0 6 6 6 6 
0 0 6 0 0 0 0 0 0 0 6 0 0 0 0 0 6 6 0 0 6 6 6 0 0 0 0 0 6 0 4 0 0 0 0 0 0 6 0 0 6 6 0 0 6 0 6 6 6 0 
0 0 6 6 0 0 0 0 6 0 6 0 6 6 6 6 6 6 6 6 6 6 6 6 6 0 6 0 6 0 4 4 4 4 4 4 4 4 0 6 0 6 0 0 6 6 6 0 6 0 
6 0 6 6 0 0 0 0 0 6 6 0 6 6 0 0 0 0 0 0 6 6 6 6 6 0 6 0 6 6 0 8 8 8 8 8 8 4 0 0 0 6 0 0 0 0 0 0 6 6 
6 0 0 6 6 0 0 0 6 6 6 0 6 6 0 6 0 6 6 0 6 6 0 0 0 0 6 0 6 6 6 8 1 1 1 1 1 2 1 1 1 1 1 0 6 6 6 8 8 0  
0 0 0 0 6 0 0 0 6 0 0 0 6 6 6 6 0 6 6 0 6 6 6 6 6 6 6 0 6 6 6 6 1 2 2 2 2 2 2 2 2 2 1 6 6 6 6 0 0 0 
6 6 6 6 0 0 0 0 6 6 6 6 6 0 0 0 0 6 6 0 6 6 0 0 0 0 0 0 6 0 6 6 1 2 2 2 2 2 2 2 2 2 1 6 0 8 8 6 0 7 
0 0 0 0 0 0 0 0 6 6 6 6 0 6 6 6 0 6 6 0 6 6 0 6 6 6 6 6 6 6 6 6 1 2 2 2 2 2 2 2 2 2 1 0 6 0 8 6 0 7 
0 0 0 0 0 0 0 0 6 6 6 0 0 6 6 6 6 6 6 6 6 6 0 6 6 6 6 6 6 0 0 6 1 2 2 2 2 2 2 2 2 2 1 6 6 0 8 8 8 7 
0 0 0 0 0 0 0 0 0 7 7 7 7 7 6 6 0 0 0 0 0 0 0 0 0 0 0 0 0 0 0 0 1 1 1 1 1 1 1 1 1 1 1 0 0 0 8 6 6 7 
0 0 0 0 0 8 0 6 6 7 7 7 7 7 7 6 6 6 6 0 0 0 0 6 0 0 8 6 0 0 0 0 8 8 0 0 0 0 0 0 0 6 6 6 0 0 8 8 0 7 
0 0 0 6 6 6 6 6 6 7 7 7 7 7 7 7 0 6 6 0 0 0 6 0 0 6 0 0 0 6 0 0 0 0 8 8 8 0 6 6 0 6 6 0 8 8 8 0 0 7 
6 6 6 6 0 0 0 6 6 7 7 7 7 7 7 7 0 0 8 6 0 8 6 6 6 0 8 0 0 0 0 0 0 0 0 0 8 0 0 0 0 0 8 8 8 0 8 0 0 0 
6 6 6 6 0 0 0 0 7 7 7 7 7 7 7 7 0 0 8 6 0 0 8 0 6 0 0 7 7 7 7 0 6 6 6 0 8 0 8 0 8 8 6 6 6 0 8 6 6 6 
6 6 6 6 0 0 6 0 7 7 7 7 7 7 7 7 7 7 6 6 6 0 0 0 0 0 0 7 7 7 7 7 7 7 7 0 6 6 0 8 8 0 0 0 6 0 8 0 8 8 